@xwxwxxwwxwxxxxwwwwx
w..................w
w..................x
x..................w
x..................w
w......bbbbbb......x
w......bcaacb......x
w......bpsspb......x
w......bbddbb......x
w..................w
w..................w
w..................x
w..................w
w..................x
