@xzxzxxzzxzxxxxzzzxx
zb...............rdz
z..............r...x
x............r.....z
x..........r.......z
x........r.........z
z......r...........x
y...brb......aaaaaPy
x..r...............x
zr.................z
x.r................z
x...r..............x
xb....r...........cz
xxxxzxzxzxxzzxxxxxxx
.....................