@xzxzxxzzxzxxxxzzzxx
zr................rz
z.r.....p........r.x
x..r............r..z
x...r....ss....r...z
x....r..s..s..r....x
x.....rs....sr.....x
x.....sr....rs.....x
x....s..r..r..s....x
x...s....rr....s...z
x..s............s..z
x.s..............s.x
xs....abcd........sz
xxxxzwzxzxxxxxxxxxxx
.....................